*************##########*****************************************
*************#........#*****************************************
*************#........#*****************************************
*************#........#*********************###############*****
*************#........#*********************#.............#*****
*************#........#*********************#.............#*****
*************#........#*********************#.............#*****
*************#........#*********************#...B.........#*****
*************#....K...#*********************#.............#*****
*************###..#####*********************#.............#*****
***************#..#*************************#.............#*****
***************#..#*************************#.............#*****
***************#..#*************************#.............#*****
***************#..#*************************#######/#######*****
************####..###*****************************#.#***********
************#.......#*****************************#.#***********
************#.......#*****************************#.#***********
************#.......#*****************************#.#***********
************#.......#*****************************#.#***********
************#.......#*****************************#.#***********
************#.......#*****************************#.#***********
************#.......#*****************************#.#***********
************#.......#*****************************#.#***********
************#.......#*****************************#.#***********
************#.......#*****************************#.#***********
************#....P..#*****************************#.#***********
************#.......#*****************************#.#***********
************#.......############******************#.#***********
************#..................####################.#####*******
************#...........................................#*******
************##.###############.##########################*******
*************#.#*************#.#********************************
*************#.#*************#.#********************************
*************#.#*************#.#********************************
*************#.#*************#.#********************************
*************#.#*************#.#********************************
*************#.#*************#.#********************************
*************#.#*************#.#********************************
*************#.#*************###********************************
*************#.#************************************************
*************#.#************************************************
*************#.#************************************************
*************#.#************************************************
*************#.#************************************************
*************#.#************************************************
*************#.#************************************************
*************#.#************************************************
*************#.#************************************************
*************#.#************************************************
*************#.#************************************************
*************#.#************************************************
*************#.#************************************************
*************#.#************************************************
*************#.#************************************************
*************#.#************************************************
*************#.#************************************************
*************#.#************************************************
*************#.#************************************************
*************#.#************************************************
*************#.#************************************************
*************#.#************************************************
*************#.################################*****************
*************#................................#*****************
*************##################################*****************
