****************************###########*************************
****************************#.........#*************************
****************************#........R#*************************
****************************#.........#*************************
****************************#.........#*************************
****************************#.........#*************************
****************************#.........##################********
****************************#..........................#********
****************************#.........################.#********
****************************#.........########*******#.#********
****************************#................#*******#.#********
****************************#.........########*******#.#********
****************************#.........#**************#.#********
****************************#.........#**************#.#********
****************************#.........#**************#.##*******
****************************#.........#**************#..#*******
****************************########.##**************#..#*******
***********************************#.#***************#..#*******
***********************************#.#***************#..#*******
***********************************#.#***************#..#*******
***********************************#.#***************#..#*******
***********************************#.#***************#..#*******
***********************************#.#***************#..#*******
***********************************#.#***************#..#*******
***********************************#.#***************#..#*******
***********************************#.#***************#..#*******
***********************************#.#***************#..#*******
***********************************#.#***************#..#*******
***********************************#.#***************#..#*******
***********************************#.#***************#..#*******
***********************************#.#***************#..#*******
***********************************#.#***************#..#*******
***********************************#.#***************#..#*******
***********************************#.#***************#..#*******
***********************************#.#***************#..#*******
***********************************#.#***************#..#*******
***********************************#.#***************#..#*******
***********************************#.#*****###########..###*****
***********************************#.#######..............#*****
***********************************#......................#*****
***********************************#########..............#*****
*******************************************#..............#*****
*******************************************#..............#*****
*******************************************#..............#*****
*******************************************#...........R..#*****
*******************************************################*****
****************************************************************
****************************************************************
****************************************************************
****************************************************************
****************************************************************
****************************************************************
****************************************************************
****************************************************************
****************************************************************
****************************************************************
****************************************************************
****************************************************************
****************************************************************
****************************************************************
****************************************************************
****************************************************************
****************************************************************
****************************************************************
